###################
#   s #           #
#     #           #
#     #           #
#                 #
#    #       #    #
#    #       # f  #
#    #       #    #
###################